#####B###
##### # #
####  # #
####    #
     ## #
A########